11111111111111111111111111111111111111111111111111111111
1E0000000000000C000000000P0000000C0000000000000000000111
10101111111110101011111111101011111110101011111111101011
10100000000010101000000000101000000010101000000000101011
10101111111110101011111110101011111110101011111111001011
10100C0C0C0001010100C0C0C0010100C0C0C0010100C0C0C0010101
10100000000010101000000000101000000010101000000000101011
10100000000010101000000000101000000010101000000000101011
10100000000010101000000000101000000010101000000000101011
100000000000000C00000000010000000C0000000000000000000111
10101111111110101011111111101011111110101011111111101011
10100000000010101000000000101000000010101000000000101011
10101111111110101011111110101011111110101011111111001011
10100C0C0C0001010100C0C0C0010100C0C0C0010100C0C0C0010101
11111111111111111111111111111111111111111111111111111111