1111111
1000011
1P0C0E1
1111111