111111111111111111111111111111111111111111111111111111111111111111
100CCCCCCCCCCCCCCCCCCCCCCCCCC0000000000000000000000000000000000001
10C00000000000000000100010000C0000000000000000000000000000C0000001
10C0C0C0C0C0C0C0C0C010C0101111C0C0C0C0C0C0C0C0C0C0C0C0C0C0C0000001
10C0000000000000000010001000C10000000000000000000000000000C0000001
10C0C0C0C0C0C0C0C0C0111110C0C1C0C0C0C0C0C0C0C0C0C0C0C0C0C0C0000001
10C0000000000000P00000001011110000000000000000000000000000C0000001
10C0C0C0C0C0C0C0C0C0C0C01010C0C0C0C0C0C0C0C0C0C0C0C0C0C0C0C0000001
10C0000000000000000000001010C00000000000000000000000000000C0000001
10C0C0C0C0C0C0C0C0C0C0C0E01111C0C0C0C0C0C0C0C0C0C0C0C0C0C0C0000001
10C0000000000000000000000000C00000000000000000000000000000C0000001
10C0C0C0C0C0C0C0C0C0C0C0C0C0C0C0C0C0C0C0C0C0C0C0C0C0C0C0C0C0000001
10C0000000000000000000000000C00000000000000000000000000000C0000001
10C0C0C0C0C0C0C0C0C0C0C0C0C0C0C0C0C0C0C0C0C0C0C0C0C0C0C0C0C0000001
111111111111111111111111111111111111111111111111111111111111111111