1111111111
1C00000001
1000001001
1000001001
10CC001111
1000111001
1000001001
1000001001
1000001001
1000000C01
1000001111
1000001111
1000001111
1000001001
1000001001
10000000C1
1P000E1001
1111111111