1111111111111111111111111111111111111111111111111111111111111
1E0000000000000C00000C000000000000C00000000000000000000000001
1010010100100000101001000000010100010101010001010100010101101
1010010010101010001001000000010101001000000000000101001000001
1P0000000C00C0000000000000000000C000000C00000000000C00000C001
1111111111111111111111111111111111111111111111111111111111111