11111111111111111
110001000C000C001
1110P0010000110C1
10000001001100001
10011C00001001001
1100C1000010E1C01
11111111111111111
